


111111111111111
1P0000000000011
111111111100011
111111100000E11
111111111111111
