111111111111111
100000000000C11
1000C1111100011
100001111100011
110C00000000011
111111101111111
1P0000000000C11
1000C1111100011
100001111100011
110C00000000E11
111111111111111