111111111111111
1P0000000000C11
1000C1111100011
100001111100011
110C000000C0011
1100000C0000011
100C00000000C11
1000C1111100011
100001111100011
110C00000000E11
111111001111111
100000000000C11
1000C1111100011
100001111100011
110C000000C0011
100000000000001
100C00000000C11
1000C1111100011
100001111100011
110C00000000011
111111111111111