111111111111111
1P0000000000111
111001111100011
111001111100011
111C10000000E11
111111111111111