111111111111111
1P0000000000C11
1000C1111100011
100001111100011
110C00000000011
110000000000011
100000000000C11
1000C1111100011
100001111100011
110C00000000E11
111111111111111